7 10
|--------|
|F.F|..-.|
|FF-|.@-.|
|..F|....|
|........|
|P....|P.|
|--------|